accueil: [[homesitewebanglnocat, mainpagesitewebanglnocat, pagedaccueilsiteweb]]
fauteuil: [[armstoel, leunstoel, luiestoel]]
meuble: [[garniture, mobilier]]
militaire: [[martial, guerrier], [soldat, trouffionfamiliernocat, bidassefamiliernocat, chairàcanonfamiliernocat, fantassin, gendarme, mercenaire, milicien]]
manchot: [[unibrassisterarenocat], [manchois]]
bande dessinée: [[artséquentiel, bédé, illustrédésuetnocat, neuvièmeart, romangraphique]]
bird: [[porridge, time, stretch]]
allemand: [[langueallemande, languedeGoethe, languedeschevauxpéjoratifnocat]]
vendredi: [[dredifrdredifamiliernocat]]
wing: [[lienfenderenUSnocatautonocat]]
voler: [[desitjar], [volença, volontat]]
armée: [[doel, paine, enui, dulor], [arme, force, forcenavale, forceterrestre, forcedintervention, métonnocatdrapeau]]
sinogramme: [[caractèrechinoispluscourant, hanjacoréen, hanzichinois, kanjijaponais]]
kanji: [[caractèrechinois, sinogramme, hanjacoréen, hanzichinois], [lienChinesecharacteren, lienhanjaen, lienhanzien]]
jour: [[journée]]
CD-ROM: [[CDparextnocat, disqueoptiquecompactdénominationrecommandéeofficiellement], [lienCDenparextnocat]]
photographie: [[photoabréviation, prisedevue]]
ordinateur: [[ordonnateur]]
année: [[lienanéegallo]]
mars: [[ugglemånad, vårmånad]]
mai: [[moisdeMarie], [jamaicajamai, archaïquenocatancfranc], [nonmai], [encaraocencara], [mama], [dinnou, iar, iarăși]]
computer: [[ordinateur], [pcnlpc, homecomputernlhomecomputer]]
anglais: [[anglophone], [anglichefamiliernocat, langueanglaise, languedeShakespeare]]
lieu: [[endroit, emplacement, localité, place]]
hypothèse: [[conjecturethéorie, postulat]]
collaboration: [[collaborativitéplusrare]]
prendre: [[agafar]]
le: [[émouvable, émotif]]
la: [[na], [lan], [lade]]
星期: [[lien周zhzhōusemaine, lien礼拜zhlǐbàisemaine]]
fin: [[finman], [final, término]]
abréviation: [[abréviature]]
火: [[불], [lien火曜日jatrkayōbisensmardi]]
procrastiner: [[atermoyer]]
sprechen: [[reden]]
Buchhandlung: [[Buchladen]]
espagnol: [[castillan, espingouinargot, languedeCervantes, langueespagnole]]
neuf: [[nouveau], [nouveau]]
et: [[ainsique, comme, pisQuébecnocat, plus, puis], [acatque, que]]
un: [[quelqueDéterminant], [lun, quelquunvieillinocat], [empreu], [unoesuno]]
nord: [[septentrion], [boréal, septentrional], [norte]]
sud: [[austroventduSud, méridienvieillinocat, midivieillinocat, miéjourventduSud], [austral, méridional]]
Samstag: [[Sonnabend]]
dico: [[legolalego], [forlafor, loquorlaloquor]]
je: [[moi, égo], [jemalsüberhaupt, jeweilspro]]
mot: [[WiktionnaireBCPpourlalistecomplètedescodeslanguesnormalisésenregistrésdanslabasededonnéesIANAdeslabelsetsouslabelsdidentificationdeslanguesrégionsécrituresvariantesetleursaliasavecleurnomenanglaisplusdeLasourceIANAestnormativeetstablemaisyvérifierquelecodenapasétérendudésuetoudéfiniavecunaliasversuncodepréférénepasutilisercescodesmaislescodesderemplacementindiqués, WiktionnaireISOpourlalistecomplèteinformativedescodesdelanguesindividuellesoumacrolanguesoucollectionslespluscourantesnormalisésàdeuxlettrescertainssontdésuetsouinstables, WiktionnaireISOpourlalistecomplèteinformativedescodesdelanguesindividuellesoumacrolanguesoucollectionslespluscourantesnormalisésàtroislettresuniquementceuxpourlesquelsexistentdescodeslangueàdeuxlettresnesontpaslistéscertainssontdésuetsouinstables, WiktionnaireISOpourlalistepartielledesautresnombreuxcodesdelanguesoumacrolangueslespluscourantesnormalisésàtroislettresuniquementdéfinisparunmodèledansleWiktionnairetousnesontpasdéfinisilyenauraitprèsdecertainssontdésuetsouinstables, WiktionnaireVérificationdesmodèlespourleslanguespourlapagedetravailsurlescodeslanguesàclasserycomprislesvariétésdialectalesetcodesspéciauxetcontrôler], [modldeldelawarevsmodldeldel, modlgswalémaniquevsmodlgswgswetmodlalsals], [httpwwwsilorgisocodesaspISOMASILorglisteofficielledescodesISOdonneaussileséquivalentsISOet, LesiteSILdéfinissaitauparavantsesproprescodesbaséssurlestravauxdeTheEthnologueetdontcertainsétaientdifférentsdeceuxfinalementretenusdanslanormeISOTouslescodesontétéconvertisLesancienscodesSILsontdésuets, UtiliserlecodeISOousilexiste, httpwwwethnologuecomwebaspEthnologueAncienneéditionlanguesrépertoriéesenanglais, CecinestpasleISOofficiellesiteutilisaitauparavantlesancienscodesSILenmajusculesetutilisedésormaislanormeISOAttentioncertainscodesexistentencoreetcorrespondaientàladernièreéditionpubliéedesonrapportsurleslanguesdumondeDepuislaparutiondelanouvelleéditioncesancienscodessontdéfinitivementabandonnésauprofitdelISOilsontpuêtremodifiésdanslanormeISOdepuissonadoptionetnotammentdes], [écrit, parole], [nagvlinder], [lienverbefro], [paraula], [geschil, herrie, nachtvlinder, onmin, ruzie, strijd, tweespalt], [emotsvemot, gentemotsvgentemot, inemotsvinemot]]
personne: [[dégunrégionProvenceHautesAlpes, nul]]
lès: [[synonyme, synonyme, ], []]
nom commun: [[nom, substantif, locutionnominalefrlocutionnominale]]
des: [[dechez], [adesea]]
僕: [[lien下僕ja]]
俺: [[zhlien我wǒ, zhlien咱zán]]
Toulouse: [[synonyme, synonyme, ], [], [Citédesviolettes, Villerose]]
O: [[WfrW]]
japonais: [[nippon], [languedeMishima, languejaponaise], [arlequin]]
verbe: [[lienngườiNhậtvi, lienngườiNhậtBảnvi]]
portugais: [[languedeCamões]]
ordre: [[bestilling]]
deux: [[couple, paire]]
Internet: [[net], [webcsweb]]
courriel: [[courrierélectronique, email, mail, mélsystèmedemessagerieélectronique, messageélectronique]]
pourriel: [[courrielindésirable, familiernocatmerdiel, anglnocatspam, familiernocatpolluriel]]
arriver: [[atteindre, réussir, parvenir]]
ensemble: [[coudeàcoude, deconcert, deconserve, enchœur, ensemblementdésuet, maindanslamain], [barre], [ensemensems]]
adjectif: [[nomadjectifdésuetnocat]]
alphabétique: [[abécédaire]]
du: [[synonyme, synonyme, ], [], [], [didu], [didu], [dó]]
Néerlandais: [[lienHollandaisfr]]
néerlandais: [[flamand, hollandaisinformelnocat, languedeVondel], [flamandfamiliernocat, hollandaisfamiliernocat]]
livre: [[indelicado, semcadência]]
habitant: [[citoyen, résident, agriculteur, paysan, campagnard, VoirfrCatégorieInsultesenfrançaisquébécoisInsultesenfrançaisquébécois], [VoirfrCatégorieInsultesenfrançaisquébécoisInsultesenfrançaisquébécois], [inhabitanteninhabitant], [resident]]
A: [[lienaceen]]
texte: [[écrit, lettre]]
article: [[produit]]
élément: [[élémentchimiquechimienocat]]
unitaire: [[religionnocatsocinien]]
chat: [[causette, clavardage, tchatche], [chatchastel], [pokeccspokec, webchatcswebchat]]
blog: [[carnetWebrarenocat, cybercarnetrarenocat, jouebtrèsrarenocat, joureltrèsrarenocat], [webovýcswebovýdeníkcsdeník]]
sujet: [[enkeling, individu, kerel, knul, persoon, snuiter, vent]]
au: [[AUconvAUanglophonie, uaconvuafrancophonie], [ocell], [kiche]]
corps: [[cflangfrcadavre, chassecartographienocat]]
gouvernement: [[overheid, regering]]
de: [[liendadebm]]
an: [[année], [anehtane]]
région: [[alentoursde, coin, environ]]
nommer: [[synonyme, synonyme, ], [], [], [baptiser]]
animal: [[lienbeasten, liencreatureen], [bestiapapanimal, CatégorieAnimauxenpapiamento]]
a priori: [[liencreaturăro, CatégorieAnimauxenroumain], [àpremièrevue]]
calculateur: [[ordinateur, calculatrice]]
tu: [[tutaj], [Brésilnocatvocê], [lientvåsv], [liendusv], [lienzdecs], [lientubzca]]
phrase: [[lienlocutionenplusrare]]
électricité: [[courant, jusélectricitéjusfamiliernocat]]
chas: [[lienkonbr]]
maçon: [[bastisseire, murador, muraire]]
jeu: [[Divertissementactivitéludiquedistractiondivertissementloisirpassetemps, Faitdesamuseramusement, Interprétationthéâtraleinterprétation, Interprétationmusicaleexécutioninterprétation, Façondejouertactiquestratégie, Manièredontsexécuteunmécanismefonctionnement, Ensembledobjetdemêmetypeassortimentensemblelotsérie, Mouvementnondésiré, Libertédemouvementlatitude, Chosefacilerigolade, Concoursconcoursloterietombola, Matérielservantàjouerensemble, Divisiondunepartiesportivemène]]
système: [[infrastructure]]
grec: [[hellène, hellénique], [languedHomère, koinèlanguecommunedelaGrèceantique], [gyros, kebab]]
singulier: [[quineressemblepasauxautresdifférentoriginalparticulierrareunique, rareouexcellentexceptionnelextraordinaireparticulier, marquesonétonnementdequelquechoseextraordinaire]]
à: [[termSenslienaico, termSenslienhàco]]
irrégulier: [[infréquent, sporadique]]
L: [[lienLsizeen], [lienLサイズja, lien大ja, lien大型jaindustrienocat]]
C: [[loitloDevantsgnpnpsxz]]
mon: [[lavache, purée], [lomeu]]
ton: [[munsemun], [tdésuetnocat], [tonalitécartographienocat], [lienlongtonentonnelongue, lienshorttonentonnecourte, lienmetrictonentonneoukilogrammes], [loteu]]
son: [[bruit], [axır], [gutnngut], [liendatse]]
student: [[vysokoškolákcsvysokoškolák]]
astronomie: [[astrofamiliernocat], [sterrenkunde], [sterrenkunde]]
ma: [[lienbafaarɔbm], [mamanlmama, mamsnlmams, moeder]]
mes: [[midis, ndërmjet], [avat, hogen]]
ta: [[to]]
notre: [[boulbafrboulba]]
nos: [[liennousfrovariantetardive, liennusfrovarianteancienneouanglonormande], [nosèl], [anos], [frňákcsfrňák]]
vos: [[lientúes, lienustedespolitesse], [vosautres], [bos]]
leur: [[contrôleur, leurleur]]
aucun: [[nulfradjindéfnul, pasunfradjindéfpasun], [pasunfrpronomindéfpasun, personnefrpronomindéfpersonnedanslecasparticulieroùlonparledepersonnes]]
ouf: [[brrrsentimentdefroid], [cflangfrfou]]
aïe: [[ahi, ayoyeQCnocat, ouille]]
argot: [[langueverte], [slangenslang], [lienjergaes], [hantýrkacshantýrka, slangcsslang]]
slang: [[jargon, cant], [groepstaal, jargon, bargoens], [hantýrkacshantýrka, žargoncsžargon]]
oh: [[zeroenzero]]
futur: [[àvenir], [fiancé, promis], [lienavenirca, lienesdevenidorca], [lienavenirca, lienaevenidorca]]
bar: [[meublesnocatbuffetzinc, termdébitdeboissonsbistrotcafépub], [loup], [baïartbardbayardbayart], [barriprobarri], [lienexcepten], [naken]]
barre: [[métallurgienocatmécaniquenocatfer, métallurgienocatmécaniquenocatselonlaformerondcarréplat]]
italien: [[languedeDantepériphrase, languedelamourpériphrase]]
là: [[lì]]
tú: [[lienvosesarchaïsmenocatouAmériquelatinenocat, lienustedespolitesse]]
pluriel: [[plurierdésuetnocat]]
marché: [[instrumentum, lotjuridique]]
catalan: [[catalanique], [languedeLulle, valencien]]
breton: [[languebretonne], [chevalbreton]]
utiliser: [[employer, exploiter, seservirde, userde]]
mandarin: [[lienmandarinorangeen]]
synonyme: [[allonymetoponymienocat], [WP]]
latin: [[languelatine, languedeCicéronpériphrase]]
eau: [[kiche]]
but: [[lienbaren, lienexcepten, lienexceptforen, lienexceptingen, lienexcludingen], [obuwiebuciorbucikbutek]]
traduire: [[translaterdésuet]]
pas: [[enjambée, rythme, graduation], [alleen, beklee, bekleed, klee, laatlyk, net, slegs], [mbas, pasi]]
quintal: [[centalquintalcourt]]
ich: [[pátio, terreiro], [ichil]]
nous: [[lienonfrinformelnocat]]
finir: [[VoirterminerSynonymesterminer, VoirmourirSynonymesmourir], [acabar, terminar]]
中国: [[中华人民共和国RépubliquepopulairedeChine], [中ellipsenocat, 中華人民共和国RépubliquepopulairedeChine, 支那], [中国地方bplcour]]
日本: [[lien和ja, lienジャパンja]]
bienvenue: [[bonnearrivéeAfriquenocat]]
auparavant: [[dabord, avant]]
enfant: [[enfantin], [lienmainatgeoclienmainatoclienmainitoc, liendròlleoc, lienpichonoclienpichòtoc]]
blanc: [[fi, finalitat, objectiu]]
welke: [[tortusefrotortuse]]
Hongrois: [[Magyar]]
lui: [[klink], [lienluprenieoeoakcldUeossPR], [egli]]
cardinal: [[écarlate, pourpre]]
premier: [[celuilà, premierétage, premierministre]]
lentement: [[Cetouvrageestdansledomainepublic, ModèleenréférencemodlRBescherelle, feuvertdroitdauteurLittréhttpfrancoisgannazfreefrLittreaccueilphpXMLittrémodèleenréférencemodlRLittré, DictionnairedelalanguefrançaisedÉmilepcLittrédeuxièmeéditionContientdesdéfinitionsetdescitationsIlestfortementdéconseillédenutiliserlesétymologiesvoirlanoticesurlesite, feuvertdroitdauteurNicothttpportailatilffrdictionnairesTLFNICOTindexhtmThresordelalangueFrançoyse, JeanpcNicotThresordelalanguefrançoyseéditionhttpportailatilffrdictionnairesTLFNICOTindexhtmTLFNICOTmodlRNicot, feuvertdroitdauteurnomwpcPaulGuérinDictionnairedesdictionnaireslettressciencesartsencyclopédieuniverselleLibrairiedesimprimeriesréuniesMotterozmodlRGuérin, httpgallicabnffrarkbptkwrPaulGuCArindictionnairelangFRTomeABISOT, httpgallicabnffrarkbptkrPaulGuCArindictionnairelangFRTomeBISPHORECHILIENavecrecherchetextuelle, httpgallicabnffrarkbptknrPaulGuCArindictionnairelangFRTomeCHILINEETREavecrecherchetextuelle, httpgallicabnffrarkbptkrPaulGuCArindictionnairedesdictionnaireslangFRTomeETREMALINTENTIONNE, httpgallicabnffrarkbptkdrPaulGuCArindictionnairedesdictionnaireslangFRTomeMALIOBURIQUEREIMS, httpgallicabnffrarkbptkbrPaulGuCArindictionnairelangFRTomeREINZZ, httpgallicabnffrarkbptkqrPaulGuCArindictionnairedesdictionnaireslangFRSupplément, feuvertdroitdauteurnomwpcAdolpheHatzfeldnomwpcArsèneDarmesteterAntoinepcThomasDictionnairegénéraldelalanguefrançaiseducommencementduXVIIesiècleànosjoursprécédéduntraitédelaformationdelalanguemodlRHatzfeldDarmesteter], [feuinconnudroitdauteurhttpwwwbdlporgBasededonnéeslexicographiquespanfrancophoneBDLPregroupedesbaseslexicographiquesdepaysetrégionsfrancophones, httpwwwbdlporgrechercheaspbase], [httpwwwraeeslangesRealAcademiaEspañolahttpbusconraeesdiccionariocabecerahtm, Dictionnairedespagnoletdétymologie, feuvertdomainepublicClaudeMariepcGattelhttpwwwgooglefrbooksviduSIvhggNqpzhQ], [àpasdetortue, àpasdhomme, doucement]]
voire: [[pournepasdire]]
dorénavant: [[àprésent, désormais, maintenant]]
dopage: [[doping]]
malveillant: [[malévole, malivole, malintentionné]]
malsain: [[scabreux]]
pareil: [[identique, similaire]]
gestion: [[administration, gérance]]
discipline: [[tucht]]
énoncer: [[formuler]]
extérieur: [[dehors]]
au-delà: [[autremonde]]
maison: [[domestique, faitmaison], [lienmaisefro]]
chaton: [[Jeunechatminetminou, Inflorescenceiule, Arbresaulediscoloresauledécoloré, AmasdepoussièremoutonminouBelgiqueNordPdCQuébec]]
foyer: [[lobbyenlobby]]
feu: [[défunt, regretté]]
déploiement: [[mahos, mahoso]]
mycélium: [[lienhyphefr]]
russe: [[russiensensrare], [languedeTolstoï, languerusse]]
avion: [[aéroplanetechniquenocat, coucoufamiliernocat, oiseauargotnocat, taxifamiliernocat, zinczingfamiliernocatargotnocat, zoziau], [lienaréogallo], [aeroplanu], [aeroplan]]
ballon: [[balouneQuébecnocat, ballondebaudruchebaudruche, matraschimienocat, référentielbondissantFrancenocatjargondelÉducationnationale]]
garçon: [[liengaminfr], [vasletfrovaslet]]
bateau: [[arnaque, entourloupe, menerenbateau]]
aléatoire: [[hasardeux, hypothétique, probable, éventuel]]
se: [[kûçikkukûçikm, segkusegm], [qlakpsqla]]
page: [[valet]]
anticipation: [[prévision, préparation]]
mettre: [[placer, poser]]
décentration: [[empathie, recul, exteriorisation]]
montgolfière: [[ballonàairchaud]]
finnois: [[finlandais, suomi]]
serpent: [[liensnakeen], [serp, CatégorieSerpentsencatalan], [slang]]
normatif: [[prescriptif]]
excipit: [[explicit]]
oligarchie: [[oligocratierarenocat]]
cercle: [[rodona]]
agriculteur: [[cultivateur, éleveur, exploitantagricole, fermier, laboureur, paysan, producteuragricole]]
vasectomie: [[stérilisationmasculine, vasotomie]]
amphigouri: [[charabia, galimatias]]
英語: [[zhlien英文Yīngwén英文anglaislangueanglaise]]
efface: [[gommeEUnocat, gommeàeffacer]]
cinétique: [[lienkinétiquefrlienkinésiquefr]]
première: [[initiative, innovation]]
deuxième: [[second]]
troisième: [[tiers], [tiers]]
os: [[vultusfaciesbucca]]
faire: [[lienfeirrgallo, lienfoueregallo, lienanjevinegallo]]
